                                                                              
                                 +----------+                                 
                                /            \                                
                               /              \                               
                   +----------+                +----------+                   
                  /            \              /            \                  
                 /              \            /              \                 
     +----------+                +----------+                +----------+     
    /            \              /            \              /            \    
   /              \            /              \            /              \   
  +                +----------+                +----------+                +  
   \              /            \              /            \              /   
    \            /              \            /              \            /    
     +----------+                +----------+                +----------+     
    /            \              /            \              /            \    
   /              \            /              \            /              \   
  +                +----------+                +----------+                +  
   \              /            \              /            \              /   
    \            /              \            /              \            /    
     +----------+                +----------+                +----------+     
    /            \              /            \              /            \    
   /              \            /              \            /              \   
  +                +----------+                +----------+                +  
   \              /            \              /            \              /   
    \            /              \            /              \            /    
     +----------+                +----------+                +----------+     
                 \              /            \              /                 
                  \            /              \            /                  
                   +----------+                +----------+                   
                               \              /                               
                                \            /                                
                                 +----------+                                 
                                                                              