                                                                                         
                                                                                         
                                                                                         
                                                                                         
                                                                                         
                                       +----------+                                      
                                      /............\                                     
                                     /..............\                                    
                         +----------+................+----------+                        
                        /............\............../............\                       
                       /..............\............/..............\                      
           +----------+................+----------+................+----------+          
          /............\............../............\............../............\         
         /..............\............/..............\............/..............\        
        +................+----------+................+----------+................+       
         \............../............\............../............\............../        
          \............/..............\............/..............\............/         
           +----------+................+----------+................+----------+          
          /............\............../............\............../............\         
         /..............\............/..............\............/..............\        
        +................+----------+................+----------+................+       
         \............../............\............../............\............../        
          \............/..............\............/..............\............/         
           +----------+................+----------+................+----------+          
          /............\............../............\............../............\         
         /..............\............/..............\............/..............\        
        +................+----------+................+----------+................+       
         \............../............\............../............\............../        
          \............/..............\............/..............\............/         
           +----------+................+----------+................+----------+          
                       \............../............\............../                      
                        \............/..............\............/                       
                         +----------+................+----------+                        
                                     \............../                                    
                                      \............/                                     
                                       +----------+                                      
                                                                                         